R  1080 720
NO ./textures/redbrick.xpm
SO ./textures/bluestone.xpm
WE ./textures/wood.xpm
EA ./textures/greystone.xpm

S ./textures/barrel.xpm

F 224,172,105
C 205,249,255

1111111111111111
1000000000000001
100000000N000011
1111111111111111
