R  1080 720
NO ./textures/redbrick.xpm
SO ./textures/bluestone.xpm
WE ./textures/wood.xpm
EA ./textures/greystone.xpm

S ./textures/barrel.xpm

F 224,172,105
C 205,249,255

111111111111111111111111111111
100000000011000000000000000011
1000000001000000000000N0000011
100000000000000000000000001111
111111111111000011111111111111
100000000000000000000000000001
111111111111100000000111111111
111111111100011111111111111111
111111111110111111111111101111
