R 1002 720

NO ./textures/redbrick.xpm
SO ./textures/bluestone.xpm
WE ./textures/wood.xpm
EA ./textures/greystone.xpm

S ./textures/barrel.xpm 	   

F 123,112,123
C 205,249,255  

1111111111111111111111111111111
1000000000000000000000000000001
1000000000000000002000000000001
1000000000000200000000020000001
1000000000000000002000000000001
1000000000000N00000002000000001
1000000000000000000000000000001
1111111111111111111111111111111
